#################################################
#A       #       #########     #           #    #
##### # ##### ###         ##### ##### ##### #####
#     #     #   ##### ###     #       #   #     #
# ##### ### ### #     # ##### ####### # ##### ###
#       #   #   ### # #     #       # #   #     #
# ######### ### ### # ##### ####### ### ### #####
#     #       #     #     #       #     # #     #
### ### ##### ########### ######### ##### ##### #
#   #   #         #       #   #         #     # #
# ##### # ####### # ### ### # ##### ######### # #
#     #   #     # # #     # #     #   #       # #
##### ##### ### # # ####### ##### ### ######### #
#       #   #   #       #         #   ######### #
# ####### ### ######### # ########### ###########
#         #   #       # # #     #   #           #
##### ### ### # ### ### # # ##### # ########### #
#   # #     #     #   #   #     # # #         # #
### ##### ### ######### ### ### ### # ######### #
#   #     # #       #   #     #   # # #       # #
# # ##### ### ##### ##### ##### ### # ##### ### #
# #   #   # #     #       #     #   #     #   # #
# ### ### # ##### ######### ######### ##### ### #
#         #       #         #           #      B#
#################################################